12 1 11
110100000000
111010000000
011001000000
100100100000
010011000000
001011000000
000100110100
000000111010
000000011001
000000100110
000000010111
000000001011